########################################################    
##                                                    ##    
##                                       *            ##    
##                ##################################  ##    
##      *         ##                              ##  ##    
##                ##                              ##  ##    
##                ##                              ##  ##    
####################                ################  ##    
                                    ##                ##    
                                    ##    ##############    
                                    ##    ##                
                                    ##    ##                
                                    ##    ################  
                      ################                  ##  
                      ##                                ##  
                      ##                *               ##  
                      ##                            *   ##  
                      ######    ##########################  
                          ##    ##                          
                          ##    ##                          
                          ##    ##                          
              ##############    ##                          
              ##                ##                          
              ##                ##                          
    ############                ##                          
    ##                          ##                          
    ##                     *    ##                          
    ##           i              ##                          
    ##                          ##                          
    ##############################                          
