############                             ################## 
##        ##                             ##        *     ## 
##  !     ##                             ##              ## 
##        ##                             ##   i          ## 
##        ############                   ##              ## 
##                  ##                   ############    ## 
################    ##                             ##    ## 
              ####  ##                             ##    ## 
                ##  ##  ############               ##    ## 
                ##  ######    *   ##               ##    ## 
                ##           i    ##               ##    ## 
                ##                ###################    ## 
                ##########                               ## 
                        ##                               ## 
                        ##        ######################### 
                ##########        ##                        
                ##                ##                        
                ##                ##                        
##################     *   #########                        
##           i             ##                               
##                         ##                               
##  #########################                               
##  ##                                                      
##  ##                                                      
##  ##  #############################                       
##  ##  ##             *           ##                       
##  ######                         ##                       
##                 *     i       ! ##                       
##                                 ##                       
#####################################                       
